
 










	Đầu Mùa Xuân cùng em đi lễ
	Lễ chùa này – vườn nắng tung bay
	Và ngàn lau – vàng màu khép nép
	Bãi sông bay – một con bướm đẹp


	Mùa Hạ qua cùng em đi lễ
	Trái mơ ngon – đồi gió mơn man
	Từ lò hương – Làn trầm nghi ngút
	Khói hương thơm – bờ tóc em rờn


	Rồi Mùa Thu cùng em đi lễ
	Có con chim đậu dưới gác chuông
	Hoà lời ca – vào làn sương sớm
	Gió heo may – rụng hết lá vàng


	Vào mùa Đông – cùng em đi lễ
	Lễ chùa này- một thoáng mưa bay
	Và ngoài sân- vài cành khô gẫy
	Gió lung lay một cánh lan gầy


	Tàn Mùa Đông vào chùa bỡ ngỡ
	Tiễn đưa em trong áo quan này
	Từng cội hoa – trầm lặng thương nhớ
	Tóc em xưa – tơ óng như mây


	Vườn chùa đây – vào nằm trong đất
	Nép bên hoa – ôi những hoa vàng
	Vườn đào tơ chập chờn cánh bướm
	Bướm khua râu – ngơ ngác bay ngang


	Mộ của em – mộ vừa mới lấp
	Có con chim – nào hót trên cây
	Lời của chim – chìm vào tiếng suối
	Suối xanh lơ – buồn khóc ai hoài









	Rồi từ đây – vườn chùa thanh vắng
	Đến thăm em – ngày tháng qua mau
	Một nụ mai – vừa nở trong nắng
	Hỡi em ơi – mây đã qua cầu (láy) à
Xem thêm:  Ba mươi năm - Lưu Trần Nguyễn

Bài thơ này đã được nhạc sĩ Phạm Duy phổ nhạc thành bài hát cùng tên.










